111111111111111
1D000000000C001
100C0000P000001
110111000011111
1E00000C0011111
111111111111111
