1111111111111111111111111111111111
1P0000000000000C00000C000000000001
1010010100100000101001000000010101
1010010010101010001001000000010101
100000000C00C0000000000000000000C1
1111111110111111111111111111111111
1111111110111111111111111111111111
100000000000000C00000C000000000001
1010010100100000101001000000010101
1010010010101010D01001000000010101
100000000000C0000000000000000000C1
1111111110111111111111111111111111
1111111110111111111111111111111111
100000000000000C00000C000000000001
1010010100100000101001000000010101
1010010010101010001001000000010101
100000000C00C0000000000000000000C1
111111111C111111111111111110111111
111111111C111111111111111110111111
111000000C00000C00000C000000000001
1E10010100100000101001000000010101
1010010010101010001001000000010101
100000000C00C0000000000000000000C1
1111111111111111111111111111111111
