111111111111111111111111111111111111111111
1P0000000000000C00000C00000000000000000001
101001010010000010100100000001010000000001
101001001010101000100100000001010000000001
100000000C00C0000000000000000000C000000001
111111101011111111111111111111111000000001
111111101011111111111111111111111000000001
100000000000000C00000C00000000000000000001
101001010010000010100100000001010000000001
101001001010101000100100000001010000000001
100000000000C0000000000000000000C000000001
111111101011111111111111111111111000000001
111111101011111111111111111111111000000001
100000000000000C00000C00000000000000000001
1010010101000001010010000000101000000D0001
101001001010101000100100000001010000000001
100000000C00C0000000000000000000C000000001
111111101C11111111111111111111111000000001
111111101C11111111111111111111111000000001
111000000C00000C00000C00000000000000000001
111001010010000010100100000001010000000001
101001001010101000100100000001010000000001
100000000C00C0000000000000000000C000000001
111111101111111111111111111111111000000001
110000000000000C00000C00000000000000000001
101001010010000010100100000001010000000001
101001001010101000100100000001010000000001
100000000C00C0000000000000000000C000000001
111111111011111111111111111111111000000001
111111111011111111111111111111111000000001
100000000000000C00000C00000000000000000001
101001010010000010100100000001010000000001
101001001010101000100100000001010000000001
100000000000C0000000000000000000C000000001
111111111011111111111111111111111000000001
111111111011111111111111111111111000000001
100000000000000C00000C00000000000000000001
101001010010000010100100000001010000000001
101001001010101000100100000001010000000001
100000000C00C0000000000000000000C000000001
111111111C11111111111111111111111000000001
111111111C11111111111111111111111000000001
111000000C00000C00000C00000000000000000001
1E1001010010000010100100000001010000000001
101001001010101000100100000001010000000001
100000000C00C0000000000000000000C000000001
111111111011111111111111111111111000000001
111111111011111111111111111111111000000001
111111111011111111111111111111111000000001
100000000000000C00000C00000000000000000001
101001010010000010100100000001010000000001
101001001010101000100100000001010000000001
100000000000C0000000000000000000C000000001
111111111011111111111111111111111000000001
111111111011111111111111111111111000000001
100000000000000C00000C00000000000000000001
101001010010000010100100000001010000000001
101001001010101000100100000001010000000001
100000000C00C0000000000000000000C000000001
111111111111111111111111111111111111111111
