1111111111111
100100000CCC1
10EP011111CC1
100011100D001
1111111111111
